######E###
###### ###
###### ###
###### ###
#   ## ###
# # ## ###
# #    ##
# ########
# ########
#S########
