######E###
###### ###
###### ###
###### ###
#   ## ###
# # ## ###
# #    ###
# ########
##########
 S########