##########
#####E####
# ### ####
##### ####
###  S  ##
##### ####
##### ## #
##########
##########
##########

