######E###
###### ###
###### ###
##E### ###
#   ## ###
# # ## ###
# #    ###
# ########
# ########
#S########
